sss0000000000d0000000000d000000000000
0000000000000000000000000000000000000
00000d0000000000000000000000000000000
000000000000000p000000000000000000000
00000000000tgggg00000000000p000000000
00000000000122230000000tgggg000000000
0000000000046665000000012223000000000
00000ggg00066600sssss0g46666000000000
0000012300066600000000666666000000000
0000046500066000000000000000000000000
00000465sss66000000000000000000000000
0000000000000000000000000000000000000
0000000000000000000000000000000000000
0000000000000000000000000000000000000
