sss0000000000d000000000000
00000000000000000000000000
000000d0000000000000000000
0000000000000000d000000000
00000000000000000000000000
00000000000000000000000000
00000000000000000000000000
00000tggg00000000000000000
00000122300000000p00000000
00000466500000tggg00000000
00000466500000122300000000
00000466500000466500000000
000004665sss00466500000000
00sss466500006666600000000
